# # # # # - # # # #
# # # # # - - - # #
# # - - - # # - # #
# - - # - - - - # #
# - # # # # # # # #