# # # # # - # # # #
# # # - # - - - # #
# # - - - # # - - #
# - - # - - - - # #
# - # # # # # # # #