# # # # # - # # # #
# # - - - - # # # #
# # - # # - # # # #
# - - # # # # # # #
# - # # # # # # # #